1000000001
1000021001
1020000001
0000000021
1000100001
1000000001
1200020001
1000010001
1000000021
1000002000