1000000001
1000001001
1020000001
0000000001
1000100001
1000000001
1000020001
1000010001
1000000001
1000002000